|W|W|W|W|W|G|W|W|W|W|W|W|W|W|W|
|W| | | | | | | | | | | | | |W|
|W|W|W|W| |W| | | | | | | | |W|
|W| | | | |W| | | | | | | | |W|
|W| | |W|W|W|W|W| | | | | | |W|
|W| | | | | | |W| | | |W|W|W|W|
|W|W|W|W| | |W|W| | | | | | |W|
|W| | | | | | | |W|W|W| | | |W|
|W| | | | | | | | | |W| | | |W|
|W| | | | | | |W|W| | | | | |W|
|W| | | | | | | | | | | | | |W|
|W| | | | |W|W|W| |W| | | | |W|
|W|W|W|W| | |W|W| |W|W| | | |W|
|W| | | | | | | | | | | | | |W|
|W|W|W|W|W|M|W|W|W|W|W|W|W|W|W|